8 8 8 8 8 8 8 8 8 8 8 8 8 8 8 8 8 8 8 8 8 8 8 8 8 8 8 8 
8 8 6 6 6 6 6 6 6 6 6 6 6 6 6 6 6 6 6 6 6 6 6 6 6 8 8 8 
8 4 9 9 9 9 9 9 9 9 9 9 9 9 10 10 10 10 10 10 10 10 10 10 10 5 8 8 
8 4 9 9 9 9 9 9 9 9 9 9 10 10 10 10 10 10 10 10 10 10 10 10 10 5 8 8
8 4 9 9 9 9 9 9 9 9 9 10 10 10 10 10 10 10 10 10 10 10 10 10 10 5 8 8 
8 4 11 11 11 9 9 9 9 9 9 10 10 10 10 10 10 10 10 10 10 10 10 10 10 5 8 8 
8 4 11 11 11 9 9 9 9 9 9 10 10 10 10 10 10 10 10 10 10 10 10 10 10 5 8 8 
8 4 11 11 11 9 9 9 9 9 9 9 10 10 10 10 10 10 9 9 9 10 10 10 10 5 8 8 
8 4 11 11 11 9 9 9 9 9 10 10 10 10 10 10 10 10 9 11 9 10 10 10 10 5 8 8 
8 4 11 11 11 9 9 9 9 9 9 10 10 10 10 10 10 10 9 11 9 10 10 10 10 5 8 8 
8 4 11 11 11 9 9 9 9 9 10 10 10 10 10 10 10 10 9 9 9 10 10 10 10 5 8 8 
8 4 11 11 11 9 9 10 10 10 10 10 10 10 10 10 10 10 10 10 10 10 10 10 10 5 8 8 
8 4 11 11 11 9 9 9 10 10 10 10 10 10 10 10 10 10 10 10 10 10 10 10 10 5 8 8 
8 4 11 11 9 9 9 9 9 10 10 10 10 10 10 10 10 10 10 10 10 10 10 10 10 5 8 8 
8 4 11 9 9 9 9 9 9 9 10 10 10 10 10 10 10 10 10 10 10 10 10 10 10 5 8 8 
8 4 10 10 9 10 10 10 10 10 10 10 10 10 10 10 10 10 10 10 10 10 10 10 10 5 8 8 
8 4 9 9 9 9 9 9 9 9 10 10 10 10 10 10 10 10 10 10 10 10 10 10 10 5 8 8 
8 4 9 9 9 9 9 9 9 9 10 10 10 10 10 10 10 10 10 10 10 10 10 10 10 5 8 8 
8 8 7 7 7 7 7 7 7 7 7 7 7 7 7 7 7 7 7 7 7 7 7 7 7 8 8 8 
8 8 8 8 8 8 8 8 8 8 8 8 8 8 8 8 8 8 8 8 8 8 8 8 8 8 8 8 
